HlyII	GATTCTAAAGGAACTGTAG	GGTTATCAAGAGTAACTTG
Ces	GGTGACACATTATCATATAAGGTG	GTAAGCGAACCTGTCTGTAACAACA
Cyt_CK1	CAATTCCAGGGGCAAGTGTC	CCTCGTGCATCTGTTTCATGAG
Cyt_CK2	CAATCCCTGGCGCTAGTGCA	GTGNAGCCTGGACGAAGTTGG
Cspa_BcAPF2	GAGATTTAAATGAGCTGTAA	CTTNTTGGCCTTCTTCTAA
Cspa_BcAPF1	GAGGAAATAATTATGACAGTT	CTTNTTGGCCTTCTTCTAA
PanC_F	TNGGTTTTGTYCCAACRATGG	CATAATCTACAGTGCCTTTCG
PanC_F7	TGGGTTTGTTCCAACAATGG	CATAATCAACTATACCGTTTG
HA3	ACGAACAATGGAGATACGGC	TTGGTAGACCCAAAATAGCACC
HB1	TCCAGATGTGAGTTTTGAAGGA	GCGCATTTGTTCCAGTCTTT
HC2	TCGAAGTGAGAGGTAAGTAAAATCC	GCAGCCGGTTCAATAATTTC
HD1	ATATTCACCTTAATCAAGAGCTGTCACG	CCAGTAAATCTGTATAATTTGCGCCC
G1L1	GAAGTCGTAACAAGGA	CAAGGCATCCACCGTA
BCET1-2	CGTATCGGTCGTTCACTCGG	AGCTTGGAGCGGAGCAGACT
BCET3-4	GTTGATTTTCCGTAGCCTGGG	TTTCTTTCCCGCTTGCCTTT
BCET5-6	TTACATTACCAGGACGTGCTTA	TGTTTGTGATTGTAATTCAGGA
HBLA1-2	GTGCAGATGTTGATGCCGAT	ATGCCACTGCGTGGACATAT
L1A-B	AATCAAGAGCTGTCACGAAT	CACCAATTGACCATGCTAAT
L2A-B	AATGGTCATCGGAACTCTAT	CTCGCTGTTCTGCTGTTAAT
nheA	TACGCTAAGGAGGGGCA	GTTTTTATTGCTTCATCGGCT
nheB	CTATCAGCACTTATGGCAG	ACTCCTAGCGGTGTTCC
nheC	CGGTAGTGATTGCTGGG	CAGCATTCGTACTTGCCAA
