fasta/Bacillus_cereus_03BB102.fasta	Bacillus_cereus
fasta/Bacillus_cereus_03BB108.fasta	Bacillus_cereus
fasta/Bacillus_cereus_AH187.fasta	Bacillus_cereus
fasta/Bacillus_cereus_AH820.fasta	Bacillus_cereus
fasta/Bacillus_cereus_ATCC10987.fasta	Bacillus_cereus
fasta/Bacillus_cereus_ATCC1457.fasta	Bacillus_cereus
fasta/Bacillus_cereus_ATCC4342.fasta	Bacillus_cereus
fasta/Bacillus_cereus_B4264.fasta	Bacillus_cereus
fasta/Bacillus_cereus_biovar_anthracis_str-CI.fasta	Bacillus_cereus
fasta/Bacillus_cereus_CP009596.fasta	Bacillus_cereus
fasta/Bacillus_cereus_D17.fasta	Bacillus_cereus
fasta/Bacillus_cereus_E33L.fasta	Bacillus_cereus
fasta/Bacillus_cereus_F837-76.fasta	Bacillus_cereus
fasta/Bacillus_cereus_FRI-35.fasta	Bacillus_cereus
fasta/Bacillus_cereus_G9241.fasta	Bacillus_cereus
fasta/Bacillus_cereus_G9842.fasta	Bacillus_cereus
fasta/Bacillus_cereus_NC7401.fasta	Bacillus_cereus
fasta/Bacillus_cereus_NZ_CP008712.fasta	Bacillus_cereus
fasta/Bacillus_cereus_NZ_CP009369.fasta	Bacillus_cereus
fasta/Bacillus_cereus_NZ_CP009605.fasta	Bacillus_cereus
fasta/Bacillus_cereus_NZ_CP009651.fasta	Bacillus_cereus
fasta/Bacillus_cereus_NZ_CP009941.1.fasta	Bacillus_cereus
fasta/Bacillus_cereus_Q1.fasta	Bacillus_cereus
fasta/Bacillus_thuringiensis_BMB171.fasta	Bacillus_thuringiensis
fasta/Bacillus_thuringiensis_Bt407.fasta	Bacillus_thuringiensis
fasta/Bacillus_thuringiensis_HD1002.fasta	Bacillus_thuringiensis
fasta/Bacillus_thuringiensis_HD-771.fasta	Bacillus_thuringiensis
fasta/Bacillus_thuringiensis_HD-789.fasta	Bacillus_thuringiensis
fasta/Bacillus_thuringiensis_MC28.fasta	Bacillus_thuringiensis
fasta/Bacillus_thuringiensis_NZ_CP009335.fasta	Bacillus_thuringiensis
fasta/Bacillus_thuringiensis_NZ_CP009600.fasta	Bacillus_thuringiensis
fasta/Bacillus_thuringiensis_NZ_CP009720.fasta	Bacillus_thuringiensis
fasta/Bacillus_thuringiensis_NZ_CP010088.fasta	Bacillus_thuringiensis
fasta/Bacillus_thuringiensis_serovar_chinensis_CT-43.fasta	Bacillus_thuringiensis
fasta/Bacillus_thuringiensis_serovar_finitimus_YBT-020.fasta	Bacillus_thuringiensis
fasta/Bacillus_thuringiensis_serovar_galleriae.fasta	Bacillus_thuringiensis
fasta/Bacillus_thuringiensis_serovar_konkukian_str97-27.fasta	Bacillus_thuringiensis
fasta/Bacillus_thuringiensis_serovar_kurstaki_str_HD-1.fasta	Bacillus_thuringiensis
fasta/Bacillus_thuringiensis_serovar_kurstaki_strHD73.fasta	Bacillus_thuringiensis
fasta/Bacillus_thuringiensis_serovar_kurstaki_str_YBT-1520.fasta	Bacillus_thuringiensis
fasta/Bacillus_thuringiensis_serovar_morrisoni.fasta	Bacillus_thuringiensis
fasta/Bacillus_thuringiensis_serovar_thuringiensis_strIS5056.fasta	Bacillus_thuringiensis
fasta/Bacillus_thuringiensis_strAl Hakam.fasta	Bacillus_thuringiensis
fasta/Bacillus_thuringiensis_YBT-1518.fasta	Bacillus_thuringiensis
